NO ./texs/north.xpm
SO ./texs/south.xpm
WE ./texs/west.xpm
EA ./texs/east.xpm

F 50,10,15
C 100,90,200

11111
10001
10E01
10001
11111
