NO ./texs/north.xpm
SO ./texs/south.xpm
WE ./texs/west.xpm
EA ./texs/east.xpm

F 00,10,15
C 100,90,200

        1111111111111111111111111
        100000000110000000000001
        1011000001110000000000001
        1001000000000000000000001
11111111101111111110000000000001
100000000011000001110111111111111
11110111111111011100000010S01
11110111111111011101010010011
11000000110101011100000010001
10000000000000001100000010011
10000000000000001101010010001
11000001110101011111000000111
11110111 1110101 101111010001
11111111 1111111 111111111111